tanggal,KASUS,MENINGGAL,SEMBUH,DIRAWAT_OR_ISOLASI,AKUMULASI_KASUS,AKUMULASI_SEMBUH,AKUMULASI_MENINGGAL,AKUMULASI_DIRAWAT_OR_ISOLASI
30-03-2020,1,2,0,-1,1,0,2,-1
31-03-2020,1,0,0,1,2,0,2,0
01-04-2020,0,0,0,0,2,0,2,0
02-04-2020,0,1,2,-3,2,2,3,-3
03-04-2020,2,0,0,2,4,2,3,-1
04-04-2020,0,0,0,0,4,2,3,-1
05-04-2020,0,0,0,0,4,2,3,-1
06-04-2020,0,0,0,0,4,2,3,-1
07-04-2020,0,0,0,0,4,2,3,-1
08-04-2020,0,0,0,0,4,2,3,-1
09-04-2020,11,0,0,11,15,2,3,10
10-04-2020,0,0,0,0,15,2,3,10
11-04-2020,0,2,0,-2,15,2,5,8
12-04-2020,0,0,0,0,15,2,5,8
13-04-2020,0,0,0,0,15,2,5,8
14-04-2020,5,2,0,3,20,2,7,11
15-04-2020,5,0,3,2,25,5,7,13
16-04-2020,7,0,0,7,32,5,7,20
17-04-2020,19,0,1,18,51,6,7,38
18-04-2020,21,0,0,21,72,6,7,59
19-04-2020,0,0,1,-1,72,7,7,58
20-04-2020,0,1,1,-2,72,8,8,56
21-04-2020,2,0,1,1,74,9,8,57
22-04-2020,0,0,0,0,74,9,8,57
23-04-2020,2,0,0,2,76,9,8,59
24-04-2020,0,0,0,0,76,9,8,59
25-04-2020,0,0,2,-2,76,11,8,57
26-04-2020,2,0,0,2,78,11,8,59
27-04-2020,1,0,0,1,79,11,8,60
28-04-2020,2,0,0,2,81,11,8,62
29-04-2020,0,0,4,-4,81,15,8,58
30-04-2020,0,0,0,0,81,15,8,58
01-05-2020,0,0,23,-23,81,38,8,35
02-05-2020,0,0,11,-11,81,49,8,24
03-05-2020,3,1,1,1,84,50,9,25
04-05-2020,0,0,1,-1,84,51,9,24
05-05-2020,5,0,6,-1,89,57,9,23
06-05-2020,1,0,6,-5,90,63,9,18
07-05-2020,0,0,3,-3,90,66,9,15
08-05-2020,2,0,2,0,92,68,9,15
09-05-2020,1,1,1,-1,93,69,10,14
10-05-2020,0,0,1,-1,93,70,10,13
11-05-2020,3,0,7,-4,96,77,10,9
12-05-2020,2,0,1,1,98,78,10,10
13-05-2020,5,0,0,5,103,78,10,15
14-05-2020,0,0,0,0,103,78,10,15
15-05-2020,4,0,3,1,107,81,10,16
16-05-2020,1,0,0,1,108,81,10,17
17-05-2020,0,1,0,-1,108,81,11,16
18-05-2020,11,0,1,10,119,82,11,26
19-05-2020,13,0,0,13,132,82,11,39
20-05-2020,0,0,0,0,132,82,11,39
21-05-2020,0,0,0,0,132,82,11,39
22-05-2020,1,0,4,-3,133,86,11,36
23-05-2020,8,1,1,6,141,87,12,42
24-05-2020,4,0,0,4,145,87,12,46
25-05-2020,0,0,0,0,145,87,12,46
26-05-2020,0,1,1,-2,145,88,13,44
27-05-2020,8,0,1,7,153,89,13,51
28-05-2020,13,1,7,5,166,96,14,56
29-05-2020,3,0,5,-2,169,101,14,54
30-05-2020,18,0,0,18,187,101,14,72
31-05-2020,0,0,0,0,187,101,14,72
01-06-2020,0,0,0,0,187,101,14,72
02-06-2020,12,0,0,12,199,101,14,84
03-06-2020,0,0,1,-1,199,102,14,83
04-06-2020,11,0,1,10,210,103,14,93
05-06-2020,3,0,11,-8,213,114,14,85
06-06-2020,2,0,5,-3,215,119,14,82
07-06-2020,1,0,0,1,216,119,14,83
08-06-2020,1,0,3,-2,217,122,14,81
09-06-2020,0,0,0,0,217,122,14,81
10-06-2020,0,0,5,-5,217,127,14,76
11-06-2020,10,0,0,10,227,127,14,86
12-06-2020,0,0,10,-10,227,137,14,76
13-06-2020,1,0,6,-5,228,143,14,71
14-06-2020,0,0,13,-13,228,156,14,58
15-06-2020,15,0,3,12,243,159,14,70
16-06-2020,0,0,2,-2,243,161,14,68
17-06-2020,8,0,10,-2,251,171,14,66
18-06-2020,1,0,0,1,252,171,14,67
19-06-2020,2,0,10,-8,254,181,14,59
20-06-2020,0,0,1,-1,254,182,14,58
21-06-2020,13,0,0,13,267,182,14,71
22-06-2020,1,0,10,-9,268,192,14,62
23-06-2020,0,0,1,-1,268,193,14,61
24-06-2020,2,0,1,1,270,194,14,62
25-06-2020,3,0,12,-9,273,206,14,53
26-06-2020,0,0,10,-10,273,216,14,43
27-06-2020,0,0,15,-15,273,231,14,28
28-06-2020,1,0,1,0,274,232,14,28
29-06-2020,0,0,3,-3,274,235,14,25
30-06-2020,0,0,2,-2,274,237,14,23
01-07-2020,8,0,1,7,282,238,14,30
02-07-2020,4,0,9,-5,286,247,14,25
03-07-2020,3,0,4,-1,289,251,14,24
04-07-2020,1,0,0,1,290,251,14,25
05-07-2020,2,0,4,-2,292,255,14,23
06-07-2020,0,0,0,0,292,255,14,23
07-07-2020,0,0,4,-4,292,259,14,19
08-07-2020,5,0,8,-3,297,267,14,16
09-07-2020,1,0,0,1,298,267,14,17
10-07-2020,0,0,4,-4,298,271,14,13
11-07-2020,6,0,6,0,304,277,14,13
12-07-2020,5,0,1,4,309,278,14,17
13-07-2020,0,0,1,-1,309,279,14,16
14-07-2020,5,0,1,4,314,280,14,20
15-07-2020,4,0,5,-1,318,285,14,19
16-07-2020,0,0,0,0,318,285,14,19
17-07-2020,0,0,0,0,318,285,14,19
18-07-2020,3,0,0,3,321,285,14,22
19-07-2020,1,0,0,1,322,285,14,23
20-07-2020,1,0,1,0,323,286,14,23
21-07-2020,0,0,0,0,323,286,14,23
22-07-2020,4,0,1,3,327,287,14,26
23-07-2020,0,0,4,-4,327,291,14,22
24-07-2020,2,0,9,-7,329,300,14,15
25-07-2020,3,0,1,2,332,301,14,17
26-07-2020,1,1,0,0,333,301,15,17
27-07-2020,2,0,0,2,335,301,15,19
28-07-2020,8,0,5,3,343,306,15,22
29-07-2020,8,1,0,7,351,306,16,29
30-07-2020,0,0,0,0,351,306,16,29
31-07-2020,60,1,0,59,411,306,17,88
01-08-2020,33,0,0,33,444,306,17,121
02-08-2020,1,0,0,1,445,306,17,122
03-08-2020,0,0,0,0,445,306,17,122
04-08-2020,0,0,0,0,445,306,17,122
05-08-2020,7,3,0,4,452,306,20,126
06-08-2020,0,0,0,0,452,306,20,126
07-08-2020,17,0,1,16,469,307,20,142
08-08-2020,9,0,0,9,478,307,20,151
09-08-2020,8,1,0,7,486,307,21,158
10-08-2020,21,0,2,19,507,309,21,177
11-08-2020,16,0,6,10,523,315,21,187
12-08-2020,27,1,0,26,550,315,22,213
13-08-2020,15,1,23,-9,565,338,23,204
14-08-2020,12,0,16,-4,577,354,23,200
15-08-2020,22,1,5,16,599,359,24,216
16-08-2020,10,1,2,7,609,361,25,223
17-08-2020,12,0,8,4,621,369,25,227
18-08-2020,0,0,0,0,621,369,25,227
19-08-2020,15,0,10,5,636,379,25,232
20-08-2020,1,2,8,-9,637,387,27,223
21-08-2020,23,1,27,-5,660,414,28,218
22-08-2020,0,1,0,-1,660,414,29,217
23-08-2020,39,2,17,20,699,431,31,237
24-08-2020,11,0,3,8,710,434,31,245
25-08-2020,10,1,48,-39,720,482,32,206
26-08-2020,7,0,11,-4,727,493,32,202
27-08-2020,50,3,6,41,777,499,35,243
28-08-2020,41,0,6,35,818,505,35,278
29-08-2020,35,2,13,20,853,518,37,298
30-08-2020,1,0,0,1,854,518,37,299
31-08-2020,88,1,23,64,942,541,38,363
01-09-2020,27,0,0,27,969,541,38,390
02-09-2020,47,0,6,41,1016,547,38,431
03-09-2020,26,0,8,18,1042,555,38,449
04-09-2020,50,0,8,42,1092,563,38,491
05-09-2020,17,0,1,16,1109,564,38,507
06-09-2020,0,0,0,0,1109,564,38,507
07-09-2020,53,2,52,-1,1162,616,40,506
08-09-2020,24,1,6,17,1186,622,41,523
09-09-2020,52,0,1,51,1238,623,41,574
10-09-2020,20,1,1,18,1258,624,42,592
11-09-2020,17,0,70,-53,1275,694,42,539
12-09-2020,21,3,36,-18,1296,730,45,521
13-09-2020,33,0,2,31,1329,732,45,552
14-09-2020,19,0,67,-48,1348,799,45,504
15-09-2020,7,0,25,-18,1355,824,45,486
16-09-2020,21,0,9,12,1376,833,45,498
17-09-2020,34,0,1,33,1410,834,45,531
18-09-2020,70,4,258,-192,1480,1092,49,339
19-09-2020,46,1,18,27,1526,1110,50,366
20-09-2020,12,1,0,11,1538,1110,51,377
21-09-2020,85,0,0,85,1623,1110,51,462
22-09-2020,23,0,6,17,1646,1116,51,479
23-09-2020,117,0,19,98,1763,1135,51,577
24-09-2020,11,0,16,-5,1774,1151,51,572
25-09-2020,147,0,13,134,1921,1164,51,706
26-09-2020,92,0,65,27,2013,1229,51,733
27-09-2020,56,0,1,55,2069,1230,51,788
28-09-2020,12,0,97,-85,2081,1327,51,703
29-09-2020,13,0,14,-1,2094,1341,51,702
30-09-2020,34,0,2,32,2128,1343,51,734
01-10-2020,16,0,1,15,2144,1344,51,749
02-10-2020,23,0,9,14,2167,1353,51,763
03-10-2020,33,0,31,2,2200,1384,51,765
04-10-2020,37,1,1,35,2237,1385,52,800
05-10-2020,39,3,68,-32,2276,1453,55,768
06-10-2020,29,0,44,-15,2305,1497,55,753
07-10-2020,9,0,99,-90,2314,1596,55,663
08-10-2020,13,0,132,-119,2327,1728,55,544
09-10-2020,0,0,0,0,2327,1728,55,544
10-10-2020,75,0,133,-58,2402,1861,55,486
11-10-2020,22,1,44,-23,2424,1905,56,463
12-10-2020,45,0,43,2,2469,1948,56,465
13-10-2020,22,0,53,-31,2491,2001,56,434
14-10-2020,11,5,1,5,2502,2002,61,439
15-10-2020,22,0,63,-41,2524,2065,61,398
16-10-2020,40,0,69,-29,2564,2134,61,369
17-10-2020,0,0,0,0,2564,2134,61,369
18-10-2020,68,1,34,33,2632,2168,62,402
19-10-2020,47,1,1,45,2679,2169,63,447
20-10-2020,23,1,76,-54,2702,2245,64,393
21-10-2020,62,0,0,62,2764,2245,64,455
22-10-2020,0,0,0,0,2764,2245,64,455
23-10-2020,114,6,14,94,2878,2259,70,549
24-10-2020,72,5,33,34,2950,2292,75,583
25-10-2020,155,1,52,102,3105,2344,76,685
26-10-2020,110,3,43,64,3215,2387,79,749
27-10-2020,84,0,0,84,3299,2387,79,833
28-10-2020,135,1,22,112,3434,2409,80,945
29-10-2020,163,2,14,147,3597,2423,82,1092
30-10-2020,67,1,20,46,3664,2443,83,1138
31-10-2020,40,0,30,10,3704,2473,83,1148
01-11-2020,17,0,3,14,3721,2476,83,1162
02-11-2020,22,0,107,-85,3743,2583,83,1077
03-11-2020,64,1,0,63,3807,2583,84,1140
04-11-2020,34,0,24,10,3841,2607,84,1150
05-11-2020,44,1,45,-2,3885,2652,85,1148
06-11-2020,42,0,18,24,3927,2670,85,1172
07-11-2020,43,4,28,11,3970,2698,89,1183
08-11-2020,84,5,82,-3,4054,2780,94,1180
09-11-2020,28,5,43,-20,4082,2823,99,1160
10-11-2020,0,0,0,0,4082,2823,99,1160
11-11-2020,158,0,14,144,4240,2837,99,1304
12-11-2020,97,5,0,92,4337,2837,104,1396
13-11-2020,74,1,64,9,4411,2901,105,1405
14-11-2020,21,0,114,-93,4432,3015,105,1312
15-11-2020,0,1,105,-106,4432,3120,106,1206
16-11-2020,2,2,0,0,4434,3120,108,1206
17-11-2020,1,1,83,-83,4435,3203,109,1123
18-11-2020,0,0,2,-2,4435,3205,109,1121
19-11-2020,21,0,1,20,4456,3206,109,1141
20-11-2020,3,0,3,0,4459,3209,109,1141
21-11-2020,0,0,0,0,4459,3209,109,1141
22-11-2020,174,0,0,174,4633,3209,109,1315
23-11-2020,273,0,13,260,4906,3222,109,1575
24-11-2020,45,0,3,42,4951,3225,109,1617
25-11-2020,28,7,388,-367,4979,3613,116,1250
26-11-2020,18,2,109,-93,4997,3722,118,1157
27-11-2020,46,3,32,11,5043,3754,121,1168
28-11-2020,26,0,51,-25,5069,3805,121,1143
29-11-2020,67,3,46,18,5136,3851,124,1161
30-11-2020,14,0,11,3,5150,3862,124,1164
01-12-2020,33,0,39,-6,5183,3901,124,1158
02-12-2020,32,1,0,31,5215,3901,125,1189
03-12-2020,77,0,222,-145,5292,4123,125,1044
04-12-2020,56,0,0,56,5348,4123,125,1100
05-12-2020,86,0,147,-61,5434,4270,125,1039
06-12-2020,113,3,77,33,5547,4347,128,1072
07-12-2020,45,5,16,24,5592,4363,133,1096
08-12-2020,41,3,9,29,5633,4372,136,1125
09-12-2020,9,0,1,8,5642,4373,136,1133
10-12-2020,72,0,23,49,5714,4396,136,1182
11-12-2020,45,1,301,-257,5759,4697,137,925
12-12-2020,50,0,146,-96,5809,4843,137,829
13-12-2020,40,3,54,-17,5849,4897,140,812
14-12-2020,97,2,53,42,5946,4950,142,854
15-12-2020,15,0,21,-6,5961,4971,142,848
16-12-2020,40,2,68,-30,6001,5039,144,818
17-12-2020,82,0,17,65,6083,5056,144,883
18-12-2020,10,2,29,-21,6093,5085,146,862
19-12-2020,49,0,34,15,6142,5119,146,877
20-12-2020,0,0,69,-69,6142,5188,146,808
21-12-2020,132,0,8,124,6274,5196,146,932
22-12-2020,33,2,56,-25,6307,5252,148,907
23-12-2020,45,0,72,-27,6352,5324,148,880
24-12-2020,17,1,102,-86,6369,5426,149,794
25-12-2020,78,1,43,34,6447,5469,150,828
26-12-2020,15,2,40,-27,6462,5509,152,801
27-12-2020,8,0,9,-1,6470,5518,152,800
28-12-2020,33,3,73,-43,6503,5591,155,757
29-12-2020,22,3,41,-22,6525,5632,158,735
30-12-2020,35,0,36,-1,6560,5668,158,734
31-12-2020,27,0,32,-5,6587,5700,158,729
01-01-2021,19,1,8,10,6606,5708,159,739
02-01-2021,19,0,98,-79,6625,5806,159,660
03-01-2021,13,0,16,-3,6638,5822,159,657
04-01-2021,63,0,40,23,6701,5862,159,680
05-01-2021,30,2,55,-27,6731,5917,161,653
06-01-2021,25,0,58,-33,6756,5975,161,620
07-01-2021,22,2,8,12,6778,5983,163,632
08-01-2021,26,0,49,-23,6804,6032,163,609
09-01-2021,60,1,87,-28,6864,6119,164,581
10-01-2021,34,0,31,3,6898,6150,164,584
11-01-2021,19,0,23,-4,6917,6173,164,580
12-01-2021,32,2,30,0,6949,6203,166,580
13-01-2021,28,1,16,11,6977,6219,167,591
14-01-2021,51,1,62,-12,7028,6281,168,579
15-01-2021,26,1,14,11,7054,6295,169,590
16-01-2021,63,0,4,59,7117,6299,169,649
17-01-2021,29,2,31,-4,7146,6330,171,645
18-01-2021,85,2,24,59,7231,6354,173,704
19-01-2021,30,0,31,-1,7261,6385,173,703
20-01-2021,34,1,28,5,7295,6413,174,708
21-01-2021,30,1,21,8,7325,6434,175,716
22-01-2021,60,2,21,37,7385,6455,177,753
23-01-2021,15,0,15,0,7400,6470,177,753
24-01-2021,23,0,64,-41,7423,6534,177,712
25-01-2021,32,0,3,29,7455,6537,177,741
26-01-2021,28,1,30,-3,7483,6567,178,738
27-01-2021,18,1,25,-8,7501,6592,179,730
28-01-2021,37,2,21,14,7538,6613,181,744
29-01-2021,27,0,22,5,7565,6635,181,749
30-01-2021,26,0,59,-33,7591,6694,181,716
31-01-2021,100,2,33,65,7691,6727,183,781
01-02-2021,50,3,10,37,7741,6737,186,818
02-02-2021,26,2,172,-148,7767,6909,188,670
03-02-2021,19,0,0,19,7786,6909,188,689
04-02-2021,36,0,53,-17,7822,6962,188,672
05-02-2021,25,0,161,-136,7847,7123,188,536
06-02-2021,19,1,33,-15,7866,7156,189,521
07-02-2021,31,0,51,-20,7897,7207,189,501
08-02-2021,10,0,67,-57,7907,7274,189,444
09-02-2021,51,4,32,15,7958,7306,193,459
10-02-2021,37,0,80,-43,7995,7386,193,416
11-02-2021,25,0,33,-8,8020,7419,193,408
12-02-2021,11,0,69,-58,8031,7488,193,350
13-02-2021,20,1,7,12,8051,7495,194,362
14-02-2021,33,0,17,16,8084,7512,194,378
15-02-2021,8,0,1,7,8092,7513,194,385
16-02-2021,14,0,7,7,8106,7520,194,392
17-02-2021,13,1,3,9,8119,7523,195,401
18-02-2021,25,0,108,-83,8144,7631,195,318
19-02-2021,11,2,70,-61,8155,7701,197,257
20-02-2021,17,2,30,-15,8172,7731,199,242
21-02-2021,24,3,22,-1,8196,7753,202,241
22-02-2021,22,0,21,1,8218,7774,202,242
23-02-2021,16,0,1,15,8234,7775,202,257
24-02-2021,15,1,19,-5,8249,7794,203,252
25-02-2021,8,0,75,-67,8257,7869,203,185
26-02-2021,19,0,14,5,8276,7883,203,190
27-02-2021,11,0,7,4,8287,7890,203,194
28-02-2021,7,1,4,2,8294,7894,204,196
01-03-2021,13,1,20,-8,8307,7914,205,188
02-03-2021,9,0,12,-3,8316,7926,205,185
03-03-2021,6,0,19,-13,8322,7945,205,172
04-03-2021,12,0,17,-5,8334,7962,205,167
05-03-2021,19,0,17,2,8353,7979,205,169
06-03-2021,13,0,18,-5,8366,7997,205,164
07-03-2021,13,0,17,-4,8379,8014,205,160
08-03-2021,17,1,3,13,8396,8017,206,173
09-03-2021,3,0,22,-19,8399,8039,206,154
10-03-2021,14,0,20,-6,8413,8059,206,148
11-03-2021,18,0,9,9,8431,8068,206,157
12-03-2021,3,0,13,-10,8434,8081,206,147
13-03-2021,4,1,5,-2,8438,8086,207,145
14-03-2021,27,0,8,19,8465,8094,207,164
15-03-2021,4,1,3,0,8469,8097,208,164
16-03-2021,2,0,22,-20,8471,8119,208,144
17-03-2021,37,1,4,32,8508,8123,209,176
18-03-2021,8,1,18,-11,8516,8141,210,165
19-03-2021,19,0,4,15,8535,8145,210,180
20-03-2021,12,0,3,9,8547,8148,210,189
21-03-2021,5,0,15,-10,8552,8163,210,179
22-03-2021,33,1,25,7,8585,8188,211,186
23-03-2021,15,0,6,9,8600,8194,211,195
24-03-2021,31,1,1,29,8631,8195,212,224
25-03-2021,42,0,21,21,8673,8216,212,245
26-03-2021,17,2,17,-2,8690,8233,214,243
27-03-2021,25,0,1,24,8715,8234,214,267
28-03-2021,20,0,8,12,8735,8242,214,279
29-03-2021,11,0,2,9,8746,8244,214,288
30-03-2021,8,0,38,-30,8754,8282,214,258
31-03-2021,23,0,4,19,8777,8286,214,277
01-04-2021,31,0,18,13,8808,8304,214,290
02-04-2021,32,1,34,-3,8840,8338,215,287
03-04-2021,56,0,43,13,8896,8381,215,300
04-04-2021,10,0,0,10,8906,8381,215,310
05-04-2021,44,0,5,39,8950,8386,215,349
06-04-2021,23,0,17,6,8973,8403,215,355
07-04-2021,34,1,21,12,9007,8424,216,367
08-04-2021,26,2,18,6,9033,8442,218,373
09-04-2021,58,1,5,52,9091,8447,219,425
10-04-2021,25,1,29,-5,9116,8476,220,420
11-04-2021,38,0,7,31,9154,8483,220,451
12-04-2021,24,2,49,-27,9178,8532,222,424
13-04-2021,87,1,22,64,9265,8554,223,488
14-04-2021,45,0,15,30,9310,8569,223,518
15-04-2021,129,0,10,119,9439,8579,223,637
16-04-2021,66,2,12,52,9505,8591,225,689
17-04-2021,69,0,37,32,9574,8628,225,721
18-04-2021,88,0,2,86,9662,8630,225,807
19-04-2021,26,1,71,-46,9688,8701,226,761
20-04-2021,86,0,36,50,9774,8737,226,811
21-04-2021,60,2,17,41,9834,8754,228,852
22-04-2021,85,1,32,52,9919,8786,229,904
23-04-2021,50,0,21,29,9969,8807,229,933
24-04-2021,101,2,38,61,10070,8845,231,994
25-04-2021,148,1,171,-24,10218,9016,232,970
26-04-2021,137,4,147,-14,10355,9163,236,956
27-04-2021,75,2,20,53,10430,9183,238,1009
28-04-2021,105,2,20,83,10535,9203,240,1092
29-04-2021,118,1,37,80,10653,9240,241,1172
30-04-2021,114,0,12,102,10767,9252,241,1274
01-05-2021,180,1,111,68,10947,9363,242,1342
02-05-2021,145,0,8,137,11092,9371,242,1479
03-05-2021,153,0,0,153,11245,9371,242,1632
04-05-2021,134,3,173,-42,11379,9544,245,1590
05-05-2021,94,0,111,-17,11473,9655,245,1573
06-05-2021,253,11,89,153,11726,9744,256,1726
07-05-2021,94,0,33,61,11820,9777,256,1787
08-05-2021,112,0,19,93,11932,9796,256,1880
09-05-2021,92,0,311,-219,12024,10107,256,1661
10-05-2021,109,0,82,27,12133,10189,256,1688
11-05-2021,147,2,132,13,12280,10321,258,1701
12-05-2021,125,0,3,122,12405,10324,258,1823
13-05-2021,98,12,255,-169,12503,10579,270,1654
14-05-2021,98,0,13,85,12601,10592,270,1739
15-05-2021,190,1,9,180,12791,10601,271,1919
16-05-2021,222,12,242,-32,13013,10843,283,1887
17-05-2021,106,1,4,101,13119,10847,284,1988
18-05-2021,164,2,128,34,13283,10975,286,2022
19-05-2021,137,0,103,34,13420,11078,286,2056
20-05-2021,205,0,281,-76,13625,11359,286,1980
21-05-2021,236,9,46,181,13861,11405,295,2161
22-05-2021,174,0,60,114,14035,11465,295,2275
23-05-2021,215,0,25,190,14250,11490,295,2465
24-05-2021,247,1,313,-67,14497,11803,296,2398
25-05-2021,191,2,21,168,14688,11824,298,2566
26-05-2021,190,3,56,131,14878,11880,301,2697
27-05-2021,411,0,82,329,15289,11962,301,3026
28-05-2021,219,8,154,57,15508,12116,309,3083
29-05-2021,456,8,175,273,15964,12291,317,3356
30-05-2021,294,7,201,86,16258,12492,324,3442
31-05-2021,161,0,16,145,16419,12508,324,3587
01-06-2021,227,22,195,10,16646,12703,346,3597
02-06-2021,351,8,42,301,16997,12745,354,3898
03-06-2021,217,13,120,84,17214,12865,367,3982
04-06-2021,200,0,120,80,17414,12985,367,4062
05-06-2021,372,2,332,38,17786,13317,369,4100
06-06-2021,273,2,9,262,18059,13326,371,4362
07-06-2021,151,0,27,124,18210,13353,371,4486
08-06-2021,218,1,426,-209,18428,13779,372,4277
09-06-2021,407,17,429,-39,18835,14208,389,4238
10-06-2021,307,0,292,15,19142,14500,389,4253
11-06-2021,300,4,288,8,19442,14788,393,4261
12-06-2021,282,1,965,-684,19724,15753,394,3577
13-06-2021,215,0,354,-139,19939,16107,394,3438
14-06-2021,120,9,30,81,20059,16137,403,3519
15-06-2021,219,0,0,219,20278,16137,403,3738
16-06-2021,351,1,506,-156,20629,16643,404,3582
17-06-2021,307,23,307,-23,20936,16950,427,3559
18-06-2021,278,0,334,-56,21214,17284,427,3503
19-06-2021,341,0,515,-174,21555,17799,427,3329
20-06-2021,337,2,213,122,21892,18012,429,3451
21-06-2021,227,0,399,-172,22119,18411,429,3279
22-06-2021,153,2,33,118,22272,18444,431,3397
23-06-2021,309,25,277,7,22581,18721,456,3404
24-06-2021,459,2,431,26,23040,19152,458,3430
25-06-2021,403,1,181,221,23443,19333,459,3651
26-06-2021,408,17,255,136,23851,19588,476,3787
27-06-2021,435,15,287,133,24286,19875,491,3920
28-06-2021,329,15,296,18,24615,20171,506,3938
29-06-2021,480,18,299,163,25095,20470,524,4101
30-06-2021,421,4,60,357,25516,20530,528,4458
01-07-2021,397,6,267,124,25913,20797,534,4582
02-07-2021,469,15,335,119,26382,21132,549,4701
03-07-2021,648,8,281,359,27030,21413,557,5060
04-07-2021,416,23,630,-237,27446,22043,580,4823
05-07-2021,408,13,534,-139,27854,22577,593,4684
06-07-2021,586,2,23,561,28440,22600,595,5245
07-07-2021,608,12,756,-160,29048,23356,607,5085
08-07-2021,456,5,33,418,29504,23389,612,5503
09-07-2021,725,10,142,573,30229,23531,622,6076
10-07-2021,481,37,570,-126,30710,24101,659,5950
11-07-2021,651,3,500,148,31361,24601,662,6098
12-07-2021,580,15,388,177,31941,24989,677,6275
13-07-2021,539,7,400,132,32480,25389,684,6407
14-07-2021,529,25,468,36,33009,25857,709,6443
15-07-2021,625,18,620,-13,33634,26477,727,6430
16-07-2021,719,13,242,464,34353,26719,740,6894
17-07-2021,892,37,192,663,35245,26911,777,7557
18-07-2021,928,31,347,550,36173,27258,808,8107
19-07-2021,704,17,553,134,36877,27811,825,8241
20-07-2021,710,23,612,75,37587,28423,848,8316
21-07-2021,520,13,434,73,38107,28857,861,8389
22-07-2021,690,17,698,-25,38797,29555,878,8364
23-07-2021,912,27,469,416,39709,30024,905,8780
24-07-2021,692,21,614,57,40401,30638,926,8837
25-07-2021,599,14,609,-24,41000,31247,940,8813
26-07-2021,473,45,507,-79,41473,31754,985,8734
27-07-2021,656,11,511,134,42129,32265,996,8868
28-07-2021,690,36,825,-171,42819,33090,1032,8697
29-07-2021,516,30,641,-155,43335,33731,1062,8542
30-07-2021,539,45,872,-378,43874,34603,1107,8164
31-07-2021,497,36,891,-430,44371,35494,1143,7734
01-08-2021,366,23,1379,-1036,44737,36873,1166,6698
02-08-2021,406,9,1086,-689,45143,37959,1175,6009
03-08-2021,575,37,902,-364,45718,38861,1212,5645
04-08-2021,503,0,818,-315,46221,39679,1212,5330
05-08-2021,445,44,609,-208,46666,40288,1256,5122
06-08-2021,512,0,421,91,47178,40709,1256,5213
07-08-2021,320,0,574,-254,47498,41283,1256,4959
08-08-2021,281,62,595,-376,47779,41878,1318,4583
09-08-2021,307,18,386,-97,48086,42264,1336,4486
10-08-2021,310,18,775,-483,48396,43039,1354,4003
11-08-2021,275,22,457,-204,48671,43496,1376,3799
12-08-2021,233,45,348,-160,48904,43844,1421,3639
13-08-2021,278,7,426,-155,49182,44270,1428,3484
14-08-2021,247,17,300,-70,49429,44570,1445,3414
15-08-2021,212,4,717,-509,49641,45287,1449,2905
16-08-2021,201,0,400,-199,49842,45687,1449,2706
17-08-2021,284,17,464,-197,50126,46151,1466,2509
18-08-2021,178,24,298,-144,50304,46449,1490,2365
19-08-2021,178,22,260,-104,50482,46709,1512,2261
20-08-2021,203,16,214,-27,50685,46923,1528,2234
21-08-2021,203,14,235,-46,50888,47158,1542,2188
22-08-2021,19,7,247,-235,50907,47405,1549,1953
23-08-2021,82,7,182,-107,50989,47587,1556,1846
24-08-2021,120,6,198,-84,51109,47785,1562,1762
25-08-2021,85,11,253,-179,51194,48038,1573,1583
26-08-2021,136,6,175,-45,51330,48213,1579,1538
27-08-2021,114,8,36,70,51444,48249,1587,1608
28-08-2021,99,8,114,-23,51543,48363,1595,1585
29-08-2021,91,9,256,-174,51634,48619,1604,1411
30-08-2021,84,6,151,-73,51718,48770,1610,1338
31-08-2021,78,11,122,-55,51796,48892,1621,1283
