tanggal,KASUS,MENINGGAL,SEMBUH,DIRAWAT_OR_ISOLASI,AKUMULASI_KASUS,AKUMULASI_SEMBUH,AKUMULASI_MENINGGAL,AKUMULASI_DIRAWAT_OR_ISOLASI
1584316800000,1,0,0,1,1,0,0,1
1584403200000,0,0,0,0,1,0,0,1
1584489600000,0,0,0,0,1,0,0,1
1584576000000,0,0,0,0,1,0,0,1
1584662400000,1,0,1,0,2,1,0,1
1584748800000,0,0,0,0,2,1,0,1
1584835200000,0,0,0,0,2,1,0,1
1584921600000,0,1,0,-1,2,1,1,0
1585008000000,0,0,0,0,2,1,1,0
1585094400000,1,1,0,0,3,1,2,0
1585180800000,0,0,0,0,3,1,2,0
1585267200000,1,0,0,1,4,1,2,1
1585353600000,0,0,0,0,4,1,2,1
1585440000000,0,0,0,0,4,1,2,1
1585526400000,2,0,1,1,6,2,2,2
1585612800000,5,0,0,5,11,2,2,7
1585699200000,6,0,1,5,17,3,2,12
1585785600000,0,1,0,-1,17,3,3,11
1585872000000,0,0,0,0,17,3,3,11
1585958400000,5,0,0,5,22,3,3,16
1586044800000,1,0,0,1,23,3,3,17
1586131200000,3,0,1,2,26,4,3,19
1586217600000,1,0,0,1,27,4,3,20
1586304000000,4,3,3,-2,31,7,6,18
1586390400000,3,0,3,0,34,10,6,18
1586476800000,3,0,3,0,37,13,6,18
1586563200000,0,0,0,0,37,13,6,18
1586649600000,1,0,5,-4,38,18,6,14
1586736000000,16,0,0,16,54,18,6,30
1586822400000,5,0,4,1,59,22,6,31
1586908800000,1,0,0,1,60,22,6,32
1586995200000,1,0,0,1,61,22,6,33
1587081600000,1,1,3,-3,62,25,7,30
1587168000000,3,0,2,1,65,27,7,31
1587254400000,1,0,1,0,66,28,7,31
1587340800000,2,0,0,2,68,28,7,33
1587427200000,3,0,3,0,71,31,7,33
1587513600000,3,0,5,-2,74,36,7,31
1587600000000,1,0,1,0,75,37,7,31
1587686400000,1,0,0,1,76,37,7,32
1587772800000,2,0,0,2,78,37,7,34
1587859200000,3,0,0,3,81,37,7,37
1587945600000,1,0,2,-1,82,39,7,36
1588032000000,10,0,1,9,92,40,7,45
1588118400000,1,0,3,-2,93,43,7,43
1588204800000,1,0,0,1,94,43,7,44
1588291200000,9,0,5,4,103,48,7,48
1588377600000,10,0,0,10,113,48,7,58
1588464000000,1,0,0,1,114,48,7,59
1588550400000,0,0,4,-4,114,52,7,55
1588636800000,6,0,1,5,120,53,7,60
1588723200000,1,0,5,-4,121,58,7,56
1588809600000,15,0,1,14,136,59,7,70
1588896000000,6,0,0,6,142,59,7,76
1588982400000,3,0,2,1,145,61,7,77
1589068800000,7,0,0,7,152,61,7,84
1589155200000,6,1,6,-1,158,67,8,83
1589241600000,10,0,0,10,168,67,8,93
1589328000000,12,0,1,11,180,68,8,104
1589414400000,4,0,7,-3,184,75,8,101
1589500800000,3,0,12,-9,187,87,8,92
1589587200000,6,0,1,5,193,88,8,97
1589673600000,5,0,3,2,198,91,8,99
1589760000000,1,0,3,-2,199,94,8,97
1589846400000,7,0,12,-5,206,106,8,92
1589932800000,2,0,8,-6,208,114,8,86
1590019200000,6,0,7,-1,214,121,8,85
1590105600000,5,0,2,3,219,123,8,88
1590192000000,5,0,6,-1,224,129,8,87
1590278400000,1,0,4,-3,225,133,8,84
1590364800000,0,0,1,-1,225,134,8,83
1590451200000,0,0,4,-4,225,138,8,79
1590537600000,2,0,9,-7,227,147,8,72
1590624000000,0,0,8,-8,227,155,8,64
1590710400000,2,0,6,-4,229,161,8,60
1590796800000,3,0,1,2,232,162,8,62
1590883200000,3,0,7,-4,235,169,8,58
1590969600000,1,0,0,1,236,169,8,59
1591056000000,0,0,1,-1,236,170,8,58
1591142400000,0,0,1,-1,236,171,8,57
1591228800000,0,0,3,-3,236,174,8,54
1591315200000,1,0,6,-5,237,180,8,49
1591401600000,4,0,5,-1,241,185,8,48
1591488000000,2,0,2,0,243,187,8,48
1591574400000,3,0,7,-4,246,194,8,44
1591660800000,2,0,0,2,248,194,8,46
1591747200000,1,0,1,0,249,195,8,46
1591833600000,2,0,5,-3,251,200,8,43
1591920000000,10,0,5,5,261,205,8,48
1592006400000,2,0,6,-4,263,211,8,44
1592092800000,5,0,1,4,268,212,8,48
1592179200000,3,0,2,1,271,214,8,49
1592265600000,1,0,4,-3,272,218,8,46
1592352000000,3,0,2,1,275,220,8,47
1592438400000,0,0,7,-7,275,227,8,40
1592524800000,1,0,4,-3,276,231,8,37
1592611200000,8,0,0,8,284,231,8,45
1592697600000,3,0,7,-4,287,238,8,41
1592784000000,0,0,0,0,287,238,8,41
1592870400000,3,0,5,-2,290,243,8,39
1592956800000,1,0,13,-12,291,256,8,27
1593043200000,7,0,3,4,298,259,8,31
1593129600000,3,0,3,0,301,262,8,31
1593216000000,2,0,1,1,303,263,8,32
1593302400000,2,0,1,1,305,264,8,33
1593388800000,0,0,1,-1,305,265,8,32
1593475200000,7,0,1,6,312,266,8,38
1593561600000,1,0,3,-2,313,269,8,36
1593648000000,6,1,4,1,319,273,9,37
1593734400000,4,0,3,1,323,276,9,38
1593820800000,1,0,1,0,324,277,9,38
1593907200000,6,0,0,6,330,277,9,44
1593993600000,8,0,5,3,338,282,9,47
1594080000000,7,0,3,4,345,285,9,51
1594166400000,3,1,1,1,348,286,10,52
1594252800000,7,0,4,3,355,290,10,55
1594339200000,7,0,3,4,362,293,10,59
1594425600000,7,0,1,6,369,294,10,65
1594512000000,1,0,3,-2,370,297,10,63
1594598400000,8,0,8,0,378,305,10,63
1594684800000,8,1,5,2,386,310,11,65
1594771200000,9,0,3,6,395,313,11,71
1594857600000,8,0,0,8,403,313,11,79
1594944000000,4,0,2,2,407,315,11,81
1595030400000,8,0,8,0,415,323,11,81
1595116800000,15,1,0,14,430,323,12,95
1595203200000,6,1,3,2,436,326,13,97
1595289600000,28,1,3,24,464,329,14,121
1595376000000,21,2,1,18,485,330,16,139
1595462400000,10,0,4,6,495,334,16,145
1595548800000,23,1,6,16,518,340,17,161
1595635200000,17,1,6,10,535,346,18,171
1595721600000,7,1,0,6,542,346,19,177
1595808000000,15,0,4,11,557,350,19,188
1595894400000,14,1,5,8,571,355,20,196
1595980800000,15,0,12,3,586,367,20,199
1596067200000,23,0,14,9,609,381,20,208
1596153600000,64,0,17,47,673,398,20,255
1596240000000,67,1,11,55,740,409,21,310
1596326400000,19,0,10,9,759,419,21,319
1596412800000,12,0,13,-1,771,432,21,318
1596499200000,12,0,14,-2,783,446,21,316
1596585600000,17,0,29,-12,800,475,21,304
1596672000000,18,0,20,-2,818,495,21,302
1596758400000,19,0,29,-10,837,524,21,292
1596844800000,16,2,27,-13,853,551,23,279
1596931200000,8,1,18,-11,861,569,24,268
1597017600000,14,1,23,-10,875,592,25,258
1597104000000,4,0,16,-12,879,608,25,246
1597190400000,20,1,25,-6,899,633,26,240
1597276800000,11,0,13,-2,910,646,26,238
1597363200000,35,2,12,21,945,658,28,259
1597449600000,46,0,4,42,991,662,28,301
1597536000000,33,0,13,20,1024,675,28,321
1597622400000,16,0,7,9,1040,682,28,330
1597708800000,18,1,13,4,1058,695,29,334
1597795200000,31,0,18,13,1089,713,29,347
1597881600000,48,2,52,-6,1137,765,31,341
1597968000000,25,1,28,-4,1162,793,32,337
1598054400000,15,1,15,-1,1177,808,33,336
1598140800000,15,0,18,-3,1192,826,33,333
1598227200000,14,1,20,-7,1206,846,34,326
1598313600000,42,0,11,31,1248,857,34,357
1598400000000,16,2,35,-21,1264,892,36,336
1598486400000,42,0,31,11,1306,923,36,347
1598572800000,20,0,24,-4,1326,947,36,343
1598659200000,47,1,21,25,1373,968,37,368
1598745600000,24,0,8,16,1397,976,37,384
1598832000000,28,2,50,-24,1425,1026,39,360
1598918400000,20,0,10,10,1445,1036,39,370
1599004800000,29,2,25,2,1474,1061,41,372
1599091200000,33,2,14,17,1507,1075,43,389
1599177600000,18,1,21,-4,1525,1096,44,385
1599264000000,21,1,20,0,1546,1116,45,385
1599350400000,11,1,41,-31,1557,1157,46,354
1599436800000,14,0,32,-18,1571,1189,46,336
1599523200000,24,1,27,-4,1595,1216,47,332
1599609600000,50,1,52,-3,1645,1268,48,329
1599696000000,50,1,30,19,1695,1298,49,348
1599782400000,49,1,15,33,1744,1313,50,381
1599868800000,43,0,12,31,1787,1325,50,412
1599955200000,49,2,7,40,1836,1332,52,452
1600041600000,33,1,23,9,1869,1355,53,461
1600128000000,26,0,15,11,1895,1370,53,472
1600214400000,48,0,50,-2,1943,1420,53,470
1600300800000,41,0,20,21,1984,1440,53,491
1600387200000,53,0,31,22,2037,1471,53,513
1600473600000,74,1,20,53,2111,1491,54,566
1600560000000,70,4,15,51,2181,1506,58,617
1600646400000,64,2,37,25,2245,1543,60,642
1600732800000,67,0,35,32,2312,1578,60,674
1600819200000,63,1,56,6,2375,1634,61,680
1600905600000,22,3,18,1,2397,1652,64,681
1600992000000,61,0,25,36,2458,1677,64,717
1601078400000,41,0,40,1,2499,1717,64,718
1601164800000,20,1,26,-7,2519,1743,65,711
1601251200000,39,0,53,-14,2558,1796,65,697
1601337600000,49,2,59,-12,2607,1855,67,685
1601424000000,36,0,29,7,2643,1884,67,692
1601510400000,37,2,49,-14,2680,1933,69,678
1601596800000,20,4,23,-7,2700,1956,73,671
1601683200000,72,1,19,52,2772,1975,74,723
1601769600000,19,1,70,-52,2791,2045,75,671
1601856000000,22,0,76,-54,2813,2121,75,617
1601942400000,20,0,40,-20,2833,2161,75,597
1602028800000,20,0,20,0,2853,2181,75,597
1602115200000,51,1,9,41,2904,2190,76,638
1602201600000,56,2,31,23,2960,2221,78,661
1602288000000,69,0,13,56,3029,2234,78,717
1602374400000,35,1,37,-3,3064,2271,79,714
1602460800000,43,1,83,-41,3107,2354,80,673
1602547200000,38,1,39,-2,3145,2393,81,671
1602633600000,26,2,20,4,3171,2413,83,675
1602720000000,45,2,55,-12,3216,2468,85,663
1602806400000,45,0,32,13,3261,2500,85,676
1602892800000,24,0,48,-24,3285,2548,85,652
1602979200000,40,1,64,-25,3325,2612,86,627
1603065600000,18,0,75,-57,3343,2687,86,570
1603152000000,13,0,51,-38,3356,2738,86,532
1603238400000,33,2,20,11,3389,2758,88,543
1603324800000,45,0,19,26,3434,2777,88,569
1603411200000,28,0,25,3,3462,2802,88,572
1603497600000,44,0,36,8,3506,2838,88,580
1603584000000,44,0,68,-24,3550,2906,88,556
1603670400000,26,0,29,-3,3576,2935,88,553
1603756800000,41,1,32,8,3617,2967,89,561
1603843200000,45,1,41,3,3662,3008,90,564
1603929600000,82,1,51,30,3744,3059,91,594
1604016000000,59,1,60,-2,3803,3119,92,592
1604102400000,32,1,23,8,3835,3142,93,600
1604188800000,16,0,13,3,3851,3155,93,603
1604275200000,32,1,49,-18,3883,3204,94,585
1604361600000,49,1,22,26,3932,3226,95,611
1604448000000,40,2,47,-9,3972,3273,97,602
1604534400000,168,2,30,136,4140,3303,99,738
1604620800000,25,1,31,-7,4165,3334,100,731
1604707200000,38,2,48,-12,4203,3382,102,719
1604793600000,34,1,32,1,4237,3414,103,720
1604880000000,32,2,62,-32,4269,3476,105,688
1604966400000,21,1,19,1,4290,3495,106,689
1605052800000,30,1,44,-15,4320,3539,107,674
1605139200000,79,3,24,52,4399,3563,110,726
1605225600000,61,2,29,30,4460,3592,112,756
1605312000000,51,1,23,27,4511,3615,113,783
1605398400000,7,1,7,-1,4518,3622,114,782
1605484800000,67,0,15,52,4585,3637,114,834
1605571200000,90,1,30,59,4675,3667,115,893
1605657600000,153,2,41,110,4828,3708,117,1003
1605744000000,108,0,50,58,4936,3758,117,1061
1605830400000,68,2,59,7,5004,3817,119,1068
1605916800000,56,2,27,27,5060,3844,121,1095
1606003200000,77,4,9,64,5137,3853,125,1159
1606089600000,82,2,100,-20,5219,3953,127,1139
1606176000000,84,6,40,38,5303,3993,133,1177
1606262400000,150,3,143,4,5453,4136,136,1181
1606348800000,103,1,61,41,5556,4197,137,1222
1606435200000,89,3,30,56,5645,4227,140,1278
1606521600000,138,4,53,81,5783,4280,144,1359
1606608000000,139,1,51,87,5922,4331,145,1446
1606694400000,41,0,66,-25,5963,4397,145,1421
1606780800000,110,1,68,41,6073,4465,146,1462
1606867200000,122,1,30,91,6195,4495,147,1553
1606953600000,189,1,77,111,6384,4572,148,1664
1607040000000,181,0,76,105,6565,4648,148,1769
1607126400000,167,2,84,81,6732,4732,150,1850
1607212800000,224,2,83,139,6956,4815,152,1989
1607299200000,99,0,59,40,7055,4874,152,2029
1607385600000,168,1,69,98,7223,4943,153,2127
1607472000000,198,2,218,-22,7421,5161,155,2105
1607558400000,191,7,104,80,7612,5265,162,2185
1607644800000,157,3,116,38,7769,5381,165,2223
1607731200000,227,1,99,127,7996,5480,166,2350
1607817600000,151,2,130,19,8147,5610,168,2369
1607904000000,111,1,57,53,8258,5667,169,2422
1607990400000,160,3,107,50,8418,5774,172,2472
1608076800000,218,3,71,144,8636,5845,175,2616
1608163200000,224,2,60,162,8860,5905,177,2778
1608249600000,211,2,199,10,9071,6104,179,2788
1608336000000,216,3,74,139,9287,6178,182,2927
1608422400000,210,8,203,-1,9497,6381,190,2926
1608508800000,186,7,175,4,9683,6556,197,2930
1608595200000,242,8,45,189,9925,6601,205,3119
1608681600000,219,1,146,72,10144,6747,206,3191
1608768000000,253,7,164,82,10397,6911,213,3273
1608854400000,256,12,155,89,10653,7066,225,3362
1608940800000,274,6,100,168,10927,7166,231,3530
1609027200000,183,3,149,31,11110,7315,234,3561
1609113600000,210,4,107,99,11320,7422,238,3660
1609200000000,282,10,295,-23,11602,7717,248,3637
1609286400000,296,11,339,-54,11898,8056,259,3583
1609372800000,257,0,119,138,12155,8175,259,3721
1609459200000,233,13,113,107,12388,8288,272,3828
1609545600000,291,2,217,72,12679,8505,274,3900
1609632000000,218,13,221,-16,12897,8726,287,3884
1609718400000,146,3,133,10,13043,8859,290,3894
1609804800000,297,3,45,249,13340,8904,293,4143
1609891200000,272,4,290,-22,13612,9194,297,4121
1609977600000,355,4,180,171,13967,9374,301,4292
1610064000000,379,7,147,225,14346,9521,308,4517
1610150400000,301,7,136,158,14647,9657,315,4675
1610236800000,282,9,234,39,14929,9891,324,4714
1610323200000,285,9,200,76,15214,10091,333,4790
1610409600000,268,3,150,115,15482,10241,336,4905
1610496000000,319,5,178,136,15801,10419,341,5041
1610582400000,291,8,128,155,16092,10547,349,5196
1610668800000,262,18,248,-4,16354,10795,367,5192
1610755200000,302,12,298,-8,16656,11093,379,5184
1610841600000,277,9,173,95,16933,11266,388,5279
1610928000000,295,6,287,2,17228,11553,394,5281
1611014400000,287,1,107,179,17515,11660,395,5460
1611100800000,287,13,188,86,17802,11848,408,5546
1611187200000,456,9,207,240,18258,12055,417,5786
1611273600000,478,5,374,99,18736,12429,422,5885
1611360000000,473,8,117,348,19209,12546,430,6233
1611446400000,210,9,186,15,19419,12732,439,6248
1611532800000,310,15,408,-113,19729,13140,454,6135
1611619200000,325,6,311,8,20054,13451,460,6143
1611705600000,427,15,383,29,20481,13834,475,6172
1611792000000,359,9,383,-33,20840,14217,484,6139
1611878400000,414,3,210,201,21254,14427,487,6340
1611964800000,317,7,262,48,21571,14689,494,6388
1612051200000,254,14,409,-169,21825,15098,508,6219
1612137600000,222,7,260,-45,22047,15358,515,6174
1612224000000,226,6,271,-51,22273,15629,521,6123
1612310400000,312,4,312,-4,22585,15941,525,6119
1612396800000,321,6,229,86,22906,16170,531,6205
1612483200000,280,2,164,114,23186,16334,533,6319
1612569600000,217,4,266,-53,23403,16600,537,6266
1612656000000,145,3,215,-73,23548,16815,540,6193
1612742400000,206,13,255,-62,23754,17070,553,6131
1612828800000,228,4,328,-104,23982,17398,557,6027
1612915200000,291,7,257,27,24273,17655,564,6054
1613001600000,261,3,259,-1,24534,17914,567,6053
1613088000000,278,11,175,92,24812,18089,578,6145
1613174400000,113,9,370,-266,24925,18459,587,5879
1613260800000,108,9,247,-148,25033,18706,596,5731
1613347200000,135,5,139,-9,25168,18845,601,5722
1613433600000,165,5,262,-102,25333,19107,606,5620
1613520000000,229,3,227,-1,25562,19334,609,5619
1613606400000,255,11,118,126,25817,19452,620,5745
1613692800000,263,4,259,0,26080,19711,624,5745
1613779200000,201,5,128,68,26281,19839,629,5813
1613865600000,175,8,257,-90,26456,20096,637,5723
1613952000000,138,7,227,-96,26594,20323,644,5627
1614038400000,228,10,242,-24,26822,20565,654,5603
1614124800000,201,6,253,-58,27023,20818,660,5545
1614211200000,228,3,256,-31,27251,21074,663,5514
1614297600000,174,4,223,-53,27425,21297,667,5461
1614384000000,228,7,218,3,27653,21515,674,5464
1614470400000,170,4,259,-93,27823,21774,678,5371
1614556800000,144,4,274,-134,27967,22048,682,5237
1614643200000,150,4,266,-120,28117,22314,686,5117
1614729600000,229,7,160,62,28346,22474,693,5179
1614816000000,228,5,280,-57,28574,22754,698,5122
1614902400000,175,0,95,80,28749,22849,698,5202
1614988800000,89,5,249,-165,28838,23098,703,5037
1615075200000,149,4,105,40,28987,23203,707,5077
1615161600000,167,6,161,0,29154,23364,713,5077
1615248000000,176,2,190,-16,29330,23554,715,5061
1615334400000,178,6,141,31,29508,23695,721,5092
1615420800000,128,1,295,-168,29636,23990,722,4924
1615507200000,203,0,170,33,29839,24160,722,4957
1615593600000,188,3,259,-74,30027,24419,725,4883
1615680000000,90,4,266,-180,30117,24685,729,4703
1615766400000,140,3,151,-14,30257,24836,732,4689
1615852800000,170,6,211,-47,30427,25047,738,4642
1615939200000,270,1,74,195,30697,25121,739,4837
1616025600000,257,6,125,126,30954,25246,745,4963
1616112000000,161,3,200,-42,31115,25446,748,4921
1616198400000,242,5,100,137,31357,25546,753,5058
1616284800000,95,4,60,31,31452,25606,757,5089
1616371200000,143,4,174,-35,31595,25780,761,5054
1616457600000,205,3,220,-18,31800,26000,764,5036
1616544000000,254,4,150,100,32054,26150,768,5136
1616630400000,258,1,193,64,32312,26343,769,5200
1616716800000,232,8,140,84,32544,26483,777,5284
1616803200000,140,11,200,-71,32684,26683,788,5213
1616889600000,127,6,179,-58,32811,26862,794,5155
1616976000000,106,6,172,-72,32917,27034,800,5083
1617062400000,283,5,238,40,33200,27272,805,5123
1617148800000,272,4,231,37,33472,27503,809,5160
1617235200000,176,5,280,-109,33648,27783,814,5051
1617321600000,254,3,165,86,33902,27948,817,5137
1617408000000,118,7,231,-120,34020,28179,824,5017
1617494400000,123,2,183,-62,34143,28362,826,4955
1617580800000,135,1,227,-93,34278,28589,827,4862
1617667200000,233,7,207,19,34511,28796,834,4881
1617753600000,272,1,200,71,34783,28996,835,4952
1617840000000,220,5,210,5,35003,29206,840,4957
1617926400000,222,6,151,65,35225,29357,846,5022
1618012800000,230,7,177,46,35455,29534,853,5068
1618099200000,130,6,203,-79,35585,29737,859,4989
1618185600000,131,3,265,-137,35716,30002,862,4852
1618272000000,232,7,231,-6,35948,30233,869,4846
1618358400000,292,5,290,-3,36240,30523,874,4843
1618444800000,221,5,267,-51,36461,30790,879,4792
1618531200000,218,6,201,11,36679,30991,885,4803
1618617600000,158,9,281,-132,36837,31272,894,4671
1618704000000,143,6,225,-88,36980,31497,900,4583
1618790400000,170,6,168,-4,37150,31665,906,4579
1618876800000,210,4,243,-37,37360,31908,910,4542
1618963200000,229,9,242,-22,37589,32150,919,4520
1619049600000,257,8,274,-25,37846,32424,927,4495
1619136000000,137,5,260,-128,37983,32684,932,4367
1619222400000,149,4,262,-117,38132,32946,936,4250
1619308800000,223,5,251,-33,38355,33197,941,4217
1619395200000,184,2,225,-43,38539,33422,943,4174
1619481600000,164,5,212,-53,38703,33634,948,4121
1619568000000,292,5,200,87,38995,33834,953,4208
1619654400000,259,2,313,-56,39254,34147,955,4152
1619740800000,262,1,257,4,39516,34404,956,4156
1619827200000,128,4,330,-206,39644,34734,960,3950
1619913600000,180,5,308,-133,39824,35042,965,3817
1620000000000,157,5,332,-180,39981,35374,970,3637
1620086400000,159,11,254,-106,40140,35628,981,3531
1620172800000,232,6,261,-35,40372,35889,987,3496
1620259200000,229,5,319,-95,40601,36208,992,3401
1620345600000,184,11,271,-98,40785,36479,1003,3303
1620432000000,137,10,261,-134,40922,36740,1013,3169
1620518400000,140,10,202,-72,41062,36942,1023,3097
1620604800000,142,5,215,-78,41204,37157,1028,3019
1620691200000,154,5,307,-158,41358,37464,1033,2861
1620777600000,217,8,232,-23,41575,37696,1041,2838
1620864000000,105,4,240,-139,41680,37936,1045,2699
1620950400000,97,13,165,-81,41777,38101,1058,2618
1621036800000,94,5,266,-177,41871,38367,1063,2441
1621123200000,135,5,158,-28,42006,38525,1068,2413
1621209600000,136,8,170,-42,42142,38695,1076,2371
1621296000000,155,3,212,-60,42297,38907,1079,2311
1621382400000,227,10,190,27,42524,39097,1089,2338
1621468800000,269,10,225,34,42793,39322,1099,2372
1621555200000,198,10,263,-75,42991,39585,1109,2297
1621641600000,138,6,212,-80,43129,39797,1115,2217
1621728000000,152,6,185,-39,43281,39982,1121,2178
1621814400000,149,7,200,-58,43430,40182,1128,2120
1621900800000,215,10,191,14,43645,40373,1138,2134
1621987200000,190,6,191,-7,43835,40564,1144,2127
1622073600000,186,7,204,-25,44021,40768,1151,2102
1622160000000,180,4,195,-19,44201,40963,1155,2083
1622246400000,211,9,169,33,44412,41132,1164,2116
1622332800000,176,12,167,-3,44588,41299,1176,2113
1622419200000,158,7,141,10,44746,41440,1183,2123
1622505600000,219,9,178,32,44965,41618,1192,2155
1622592000000,268,4,129,135,45233,41747,1196,2290
1622678400000,206,7,145,54,45439,41892,1203,2344
1622764800000,299,5,161,133,45738,42053,1208,2477
1622851200000,150,6,107,37,45888,42160,1214,2514
1622937600000,295,5,211,79,46183,42371,1219,2593
1623024000000,253,5,207,41,46436,42578,1224,2634
1623110400000,237,8,200,29,46673,42778,1232,2663
1623196800000,304,7,210,87,46977,42988,1239,2750
1623283200000,455,9,233,213,47432,43221,1248,2963
1623369600000,417,9,217,191,47849,43438,1257,3154
1623456000000,436,10,210,216,48285,43648,1267,3370
1623542400000,466,8,226,232,48751,43874,1275,3602
1623628800000,428,5,208,215,49179,44082,1280,3817
1623715200000,438,17,211,210,49617,44293,1297,4027
1623801600000,534,15,280,239,50151,44573,1312,4266
1623888000000,595,18,270,307,50746,44843,1330,4573
1623974400000,592,12,237,343,51338,45080,1342,4916
1624060800000,638,10,275,353,51976,45355,1352,5269
1624147200000,665,15,280,370,52641,45635,1367,5639
1624233600000,662,12,218,432,53303,45853,1379,6071
1624320000000,675,15,260,400,53978,46113,1394,6471
1624406400000,694,17,273,404,54672,46386,1411,6875
1624492800000,791,11,258,522,55463,46644,1422,7397
1624579200000,783,16,277,490,56246,46921,1438,7887
1624665600000,782,22,233,527,57028,47154,1460,8414
1624752000000,831,19,308,504,57859,47462,1479,8918
1624838400000,859,32,330,497,58718,47792,1511,9415
1624924800000,850,18,390,442,59568,48182,1529,9857
1625011200000,892,30,351,511,60460,48533,1559,10368
1625097600000,895,37,365,493,61355,48898,1596,10861
1625184000000,922,24,353,545,62277,49251,1620,11406
1625270400000,1358,36,424,898,63635,49675,1656,12304
1625356800000,1615,38,524,1053,65250,50199,1694,13357
1625443200000,1465,32,623,810,66715,50822,1726,14167
1625529600000,1386,52,779,555,68101,51601,1778,14722
1625616000000,1370,32,800,538,69471,52401,1810,15260
1625702400000,1424,38,918,468,70895,53319,1848,15728
1625788800000,1665,44,902,719,72560,54221,1892,16447
1625875200000,1809,37,718,1054,74369,54939,1929,17501
1625961600000,1895,50,710,1135,76264,55649,1979,18636
1626048000000,1731,47,782,902,77995,56431,2026,19538
1626134400000,2731,39,842,1850,80726,57273,2065,21388
1626220800000,2350,66,1044,1240,83076,58317,2131,22628
1626307200000,2706,54,1027,1625,85782,59344,2185,24253
1626393600000,1661,65,1235,361,87443,60579,2250,24614
1626480000000,2522,85,1069,1368,89965,61648,2335,25982
1626566400000,2119,48,780,1291,92084,62428,2383,27273
1626652800000,1992,53,1333,606,94076,63761,2436,27879
1626739200000,1872,69,1152,651,95948,64913,2505,28530
1626825600000,1648,87,1038,523,97596,65951,2592,29053
1626912000000,1978,88,1034,856,99574,66985,2680,29909
1626998400000,1431,97,976,358,101005,67961,2777,30267
